+0x1+0x1+0x1+0x1+0x1+0x1+0x1+0x1+0x1+0x1+0x1+0x1
+0x1+0x1+0x1+0x0+0x0+0x5+0x0+0x5+0x0+0x1+0x1+0x1
+0x1+0x1+0x1+0x0+0x0+0x0+0x0+0x0+0x0+0x1+0x1+0x1
+0x1+0x1+0x1+0x3+0x0+0x0+0x0+0x0+0x9+0x1+0x1+0x1
+0x1+0x1+0x1+0x0+0x3+0x0+0x0+0x0+0x0+0x1+0x1+0x1
+0x1+0x1+0x1+0x1+0x1+0x3+0x0+0x0+0x0+0x1+0x1+0x1
